ONLINE APPLICATION	
Learning Centers - onapp.module.SetupLearningCentreModule
Programs - onapp.module.SetupProgramModule
Program Offerings - onapp.module.SetupProgramOfferingModule
Exam Subjects - onapp.module.SetupExamSubjectModule
Institution for Online Application - onapp.module.SetupInstitutionModule
Admission Policy - onapp.module.SetupAdmissionCriteriaModule
Exam Result Mapper - onapp.module.OnappExamResultMapperModule
Intake Sessions for Online Application - onapp.module.SetupIntakeSessionModule
Interview Sessions for Online Application - onapp.module.SetupInterviewSessionModule
Online Application - onapp.module.ApplicationFormEditModule
Applications Records - onapp.module.ApplicantListModule
Applicant Statistic Report - onapp.module.ApplicantReportModule

ACADEMIC STRUCTURE SETUP
Institution and Learning Centers - educate.sis.module.InstitutionModule
Period Structure - educate.sis.module.SetupStudyPeriodModule
Period Structure (Extend) - educate.sis.module.SetupStudyPeriodModule2
Study Session - educate.sis.registration.SetupIntakeModule2
Faculties and Programs - educate.sis.module.SetupFacultyModule
Subjects - educate.sis.module.SubjectSetupModule
Program Structures - educate.sis.module.ProgramStructureModule2
Student Statuses - educate.sis.module.StatusTypeConfigModule
Subject's Registration Categories - educate.sis.module.SetupSubjectCategoryModule

ENROLMENT
Student's Number Setup - educate.sis.module.MatricNumberSetupModule
Student's Registration - educate.admission.module.StudentRegistrationModule
Student's Subjects Enrollment - educate.sis.module.SubjectRegistrationModule
Student's Statuses - educate.sis.module.StudentStatusModule
Student's Statuses (Extend) - educate.sis.module.StudentStatusAdminModule
Student's Records - educate.sis.module.StudentRecordModule
Subjects Enrollment Report - educate.admission.module.SubjectRegistrationListModule
Student's Enrollment Information - educate.sis.module.StudentInformationModule
Student's Subject Registration Dates - educate.admission.module.SubjectRegistrationDateModule
Subject Registration Offering - educate.sis.module.SubjectRegistrationOfferingModule

STUDENT MODULES
Enrollment Information - educate.sis.module.StudentInformationModule2
Subjects Registration - educate.sis.module.StudentRegisterSubjectModule2


FINANCE
Payments Schedule - educate.sis.finance.module.StudentPaymentScheduleModule
Daily Collection Report - educate.sis.finance.module.CollectionReportModule
Payments Aging Report - educate.sis.finance.module.StudentPaymentAgingReportModule
Payments Report - educate.sis.finance.module.PaymentReportModule
Student's Payment List - educate.sis.finance.module.PaymentListModule

EXAMINATION
Academic Standing Setup - educate.sis.exam.module.SetupStandingModule
Academic Standing Rules Setup - educate.sis.exam.module.SetupStandingRuleModule
Subject's Result Status Setup - educate.sis.module.SetupSubjectResultStatusModule
Subject's Grading Setup - educate.sis.module.SubjectGradingSetupModule
Exam Result Entry by Subject - educate.sis.module.AssessmentResultModule
Exam Result Entry by Subject (By Teacher) - educate.sis.module.AssessmentResultByTeacherModule
Student's Exam Result Transcript - educate.sis.module.StudentExamTranscriptModule
Result Markings by Student (Admin Only) - educate.sis.module.StudentMarkEntryModule

TIMETABLE MANAGEMENT

USERS
Users Registration Manager - akari.timetable.module.UserRegistrationRecordsModule

CALENDAR & HOLIDAY
Academic Calendar - akari.timetable.module.AcademicCalendarModule2
Academic Calendar (For Admin) - akari.timetable.module.AcademicCalendarAdminModule2
Academic Calendar (For Guest) - akari.timetable.module.AcademicCalendarGuestModule
Delivery Periods - akari.timetable.module.SetupDeliveryPeriodModule
Audit Trail Log - akari.timetable.module.AuditTrailLogModule
Academic Activity Action Setup - akari.timetable.module.SetupAcademicActivityActionModule
Academic Actity Types Setup - akari.timetable.module.SetupAcademicActivityTypeModule
Campus Faculties Setup - akari.timetable.module.SetupFacultiesModule
Holiday Calendar - akari.timetable.module.SetupHolidayCalendarModule

PRE-SETUP
Teaching & Learning Activitiy Categories - educate.timetabling.module.SetupLearningActivityTypeModule
Class Activity Types - educate.timetabling.module.SetupClassroomTypeModule

ROOMS MANAGEMENT
Campus & Rooms Management (For Admin) - educate.timetabling.module.SetupCampusesModule2
Rooms Management - educate.timetabling.module.SetupCampusesModule3
Zone Management - educate.timetabling.module.ZoneManagementModule

TIMETABLE GENERATION
Slots - educate.timetabling.module.SetupSlotTimeModule
Slots Availability - educate.timetabling.module.SetupSlotTimeStudyModeModule
Student Groups - educate.timetabling.module.SetupClassroomGroupFacultyModule2
Lecturers Constraint - educate.timetabling.module.SetupTeacherGroupModule
Lecturers - educate.timetabling.module.SetupTeacherModule2
Activity Sessions - educate.timetabling.module.SetupActivitySessionModule
Pre-Define Course Activities - educate.timetabling.module.PreDefineSubjectActivityModule
Generate Timetable - educate.timetabling.module.SetupClassroomTemplateModule

TIMETABLE REPORTS
Timetable Report (Slots) - educate.timetabling.module.ClassroomTimetableModule
Timetable Report (Schedules)- educate.timetabling.module.ClassroomListModule
Lecturers Workloads Report - educate.timetabling.module.TeachersWorkloadReportModule












